11111111
1C0000E1
1P0010C1
11111111
